1111111111111111111111111
1001000000000000000000001
1000000000000000000000001
1001001011011000000000001
1000000000000000000000001
1001000000000001000000001
1000110111011000000000001
1000000000000001000000001
1001000000001000000000001
1001001001001001000011011
1000001000000001000000001
1001001001001000001000001
1000000001000001001001001
1001001000001001000001001
1001000001001000001000001
1000001001001001001001001
1001001001000001000001001
1000000000000000000000001
1001000100101101101110001
1000001000000000000000001
1000000000000000000000001
1010110001101101010110101
1000000000000000000000000
1000000000000000000000000
1111111111111111111111111