1111111111111111111111111
1000000000000000000000001
1000000000000000000000001
1010110101101101001011001
1000000000000001000000001
1000000000000000000001001
1001000101101001011001001
1001001000000000000000001
1000000000001000000001001
1001001001001010101011001
1000000001000000000000001
1000000000000000000000001
1001010101101011010101101
1001000001000001000001000
1000000000000000000000000
1001001001001001001001001
1000001001001001001001001
1001000000000000000000001
1001001001001001001001001
1000000000000000000000001
1000001000001000001000001
1011010101101101010101101
0000000000000000000000000
0000000000000000000000000
1111111111111111111111111