1111001111111111111111111
1001000000000000000000001
1001000000000000000000001
1001111111111111111111001
1000001000010000100000001
1000000000010001000000001
1000000010010000000111001
1000001000010000001000011
1000000000010000010000101
1000000000010000000000001
1000100000010000000010001
1001000000010001000000001
1000000000010000000000001
1000111111111111111111001
1000000000010000000000001
1000000000001001001000001
1000010000000000000001001
1000000000100000000000001
1000000000100111111111111
1001111111000000000000001
1000000000100000000000001
1000000000011111111111001
1001000100000000000000001
1000000000000000000000001
1111111111111111111111111