1111111111111111111111111
1000000000000000000000001
1000000000000000000000001
1000000000000000000100001
1000000000000000001000001
1000000000000000010000001
1000000000000000100000001
1000000000000001000000001
1000000000000010000000001
1000000000000100000000001
1000000000001000000000001
1000000000010000000000001
1000000000100000000000001
1000000001000000000000001
1000000010000000000000001
1000000100000000000000001
1000001000000000000000001
1000010000000000000000001
1000100000000000000000001
1001000000000000000000001
1010000000000000000000001
1100000000000000000000001
1000000000000000000000001
1000000000000000000000001
1001111111111111111111111