1111111111111111111111111
1000000000000000000000001
1000000000000000000000001
1000000000000000000000001
1000000000000000000000001
1000000000000000000000001
1000000000100111100000001
1000000000000100000000001
1000000000001100000000001
1000001000001100000000001
1000000000001100000000001
1000000000011100000000001
1000001001111111000000001
1000000000011100000000001
1000000000001000000000001
1000000000001000000000001
1000000000001000000000001
1000000000000000000000001
1000000000000000000000001
1000000000000000000000001
1000000000000000000000001
1000000000000000000000001
1000000000000000000000000
1000000000000000000000000
1111111111001111111111111