1111111111111111111111111
1000000000000000000000001
1000000000000000000000001
1010110101101101001011001
1000000000000001000000001
1000000000000000000001001
1001000101101001011001001
1001001000000000000000001
1000000000001000000001001
1001001001001010101011001
1000000001000000000000001
1000000000000000000000001
1001010101101011010101101
1000000000000000000000001
1000000000000000000000001
1000000000000000000000001
1000000000000000000000001
1000000000000000000000001
1000000000000000000000001
1000000000000000000000001
1000000000000000000000001
1000000000000000000000001
1000000000000000000000001
1000000000000000000000001
1111111111111111111111111